20
15
11  11	11 	10	10 	11	10 	10	11 	10	11 	11	10 	11	10 	11	10 	10	11  11
10  10	10 	11	11 	11	11 	11	10 	19	11 	10	11 	11	11 	10	10 	11	10  10
10  11	11 	10	11 	11	11 	19	16 	00	15 	10	11 	10	10 	11	10 	11	10  11
11  10	10 	11	10 	11	16 	00	00 	00	00 	1A	11 	10	11 	11	10 	11	11  10
11  10	11 	10	11 	16	00 	00	04 	02 	03	1A 	10	10 	10	11 	11	10 	11  10
11  10	11 	11	18 	00	00 	00	13 	17	17 	11	19 	19	10 	10	10 	11	11  10
11  11	10 	11	18 	00	00 	1B	19 	19	19 	16	00 	00	15 	11	11 	11	11  11
11  10	11 	11	18 	03	00 	00	00 	00	00 	00	00 	00	00 	1A	10 	11	11  10
10  11	10 	10	10 	14	00 	00	00 	00	00 	00	00 	03	00 	1A	11 	10	10  11
10  11	11 	11	11 	10	14 	00	00 	01	00 	00	00 	13	17 	10	10 	10	10  11
11  11	10 	11	10 	11	18 	00	1B 	1F	1D 	00	1B 	10	11	11	10 	11	11  11
11  10	10 	10	11 	11	18 	00	00	00	00 	00	00 	1A	11 	10	10 	10	11  10
10  11	10 	11	11 	11	18 	04	03 	00	00 	13	17 	10	11	11	10 	11	10  11
11  10	11 	10	11 	11	10 	17	17 	17	17 	10	11	11	11 	10	11 	11	11  10
11  10	11 	11	10 	10	11 	11	10 	10	11 	10	11 	10	10 	10	10 	10	11  10
